Subject	Predicate	Object
melB	is homologous to	melB(Salmonella)
ispE	is homologous to	ispE(Salmonella)
livM	is homologous to	livM(Salmonella)
nadC	is homologous to	nadC(Salmonella)
satP	is homologous to	satP(Salmonella)
fepD	is homologous to	fepD(Salmonella)
rnk	is homologous to	rnk(Salmonella)
cspE	is homologous to	cspE(Salmonella)
ybeF	is homologous to	ybeF(Salmonella)
holA	is homologous to	holA(Salmonella)
gltJ	is homologous to	gltJ(Salmonella)
ybeZ	is homologous to	ybeZ(Salmonella)
umpH	is homologous to	umpH(Salmonella)
chiP	is homologous to	chiP(Salmonella)
fur	is homologous to	fur(Salmonella)
dtpD	is homologous to	dtpD(Salmonella)
nhaR	is homologous to	nhaR(Salmonella)
fkpB	is homologous to	fkpB(Salmonella)
tolQ	is homologous to	tolQ(Salmonella)
tolR	is homologous to	tolR(Salmonella)
pal	is homologous to	pal(Salmonella)
modB	is homologous to	modB(Salmonella)
ftsI	is homologous to	ftsI(Salmonella)
ftsW	is homologous to	ftsW(Salmonella)
ftsA	is homologous to	ftsA(Salmonella)
ldtB	is homologous to	ldtB(Salmonella)
iaaA	is homologous to	iaaA(Salmonella)
gsiD	is homologous to	gsiD(Salmonella)
artQ	is homologous to	artQ(Salmonella)
cspD	is homologous to	cspD(Salmonella)
yadS	is homologous to	yadS(Salmonella)
rarA	is homologous to	rarA(Salmonella)
cdsA	is homologous to	cdsA(Salmonella)
proS	is homologous to	proS(Salmonella)
rpsA	is homologous to	rpsA(Salmonella)
ycaR	is homologous to	ycaR(Salmonella)
yccF	is homologous to	yccF(Salmonella)
yccX	is homologous to	yccX(Salmonella)
tusE	is homologous to	tusE(Salmonella)
phoB	is homologous to	phoB(Salmonella)
acpH	is homologous to	acpH(Salmonella)
ycdX	is homologous to	ycdX(Salmonella)
pabC	is homologous to	pabC(Salmonella)
cyoB	is homologous to	cyoB(Salmonella)
bolA	is homologous to	bolA(Salmonella)
ybaV	is homologous to	ybaV(Salmonella)
fadM	is homologous to	fadM(Salmonella)
queC	is homologous to	queC(Salmonella)
decR	is homologous to	decR(Salmonella)
glnK	is homologous to	glnK(Salmonella)
amtB	is homologous to	amtB(Salmonella)
mipA	is homologous to	mipA(Salmonella)
ybaN	is homologous to	ybaN(Salmonella)
allB	is homologous to	allB(Salmonella)
fepG	is homologous to	fepG(Salmonella)
tyrS	is homologous to	tyrS(Salmonella)
mdtJ	is homologous to	mdtJ(Salmonella)
mdtI	is homologous to	mdtI(Salmonella)
adhP	is homologous to	adhP(Salmonella)
ydcZ	is homologous to	ydcZ(Salmonella)
lapB	is homologous to	lapB(Salmonella)
pgpB	is homologous to	pgpB(Salmonella)
yciK	is homologous to	yciK(Salmonella)
ychE	is homologous to	ychE(Salmonella)
tdk	is homologous to	tdk(Salmonella)
rssB	is homologous to	rssB(Salmonella)
ychN	is homologous to	ychN(Salmonella)
ychF	is homologous to	ychF(Salmonella)
ycgM	is homologous to	ycgM(Salmonella)
yoaA	is homologous to	yoaA(Salmonella)
manY	is homologous to	manY(Salmonella)
exoX	is homologous to	exoX(Salmonella)
ftnB	is homologous to	ftnB(Salmonella)
pgsA	is homologous to	pgsA(Salmonella)
yeeY	is homologous to	yeeY(Salmonella)
tyrA	is homologous to	tyrA(Salmonella)
yfjD	is homologous to	yfjD(Salmonella)
grpE	is homologous to	grpE(Salmonella)
bamE	is homologous to	bamE(Salmonella)
ratA	is homologous to	ratA(Salmonella)
mprA	is homologous to	mprA(Salmonella)
yqaB	is homologous to	yqaB(Salmonella)
mltB	is homologous to	mltB(Salmonella)
hypC	is homologous to	hypC(Salmonella)
trhP	is homologous to	trhP(Salmonella)
yegT	is homologous to	yegT(Salmonella)
yohD	is homologous to	yohD(Salmonella)
gcvA	is homologous to	gcvA(Salmonella)
ygdQ	is homologous to	ygdQ(Salmonella)
zapA	is homologous to	zapA(Salmonella)
yggE	is homologous to	yggE(Salmonella)
epd	is homologous to	epd(Salmonella)
loiP	is homologous to	loiP(Salmonella)
napB	is homologous to	napB(Salmonella)
yfaV	is homologous to	yfaV(Salmonella)
ansB	is homologous to	ansB(Salmonella)
gss	is homologous to	gss(Salmonella)
nuoB	is homologous to	nuoB(Salmonella)
nuoA	is homologous to	nuoA(Salmonella)
exbD	is homologous to	exbD(Salmonella)
yfcC	is homologous to	yfcC(Salmonella)
ygiN	is homologous to	ygiN(Salmonella)
nudF	is homologous to	nudF(Salmonella)
ygiC	is homologous to	ygiC(Salmonella)
hldE	is homologous to	hldE(Salmonella)
fabB	is homologous to	fabB(Salmonella)
yfcZ	is homologous to	yfcZ(Salmonella)
mlaA	is homologous to	mlaA(Salmonella)
yhaH	is homologous to	yhaH(Salmonella)
garL	is homologous to	garL(Salmonella)
dolP	is homologous to	dolP(Salmonella)
nudK	is homologous to	nudK(Salmonella)
yfgO	is homologous to	yfgO(Salmonella)
hda	is homologous to	hda(Salmonella)
secG	is homologous to	secG(Salmonella)
glmM	is homologous to	glmM(Salmonella)
rplU	is homologous to	rplU(Salmonella)
fdx	is homologous to	fdx(Salmonella)
iscA	is homologous to	iscA(Salmonella)
iscU	is homologous to	iscU(Salmonella)
lptC	is homologous to	lptC(Salmonella)
tadA	is homologous to	tadA(Salmonella)
grcA	is homologous to	grcA(Salmonella)
yfiF	is homologous to	yfiF(Salmonella)
pssA	is homologous to	pssA(Salmonella)
clpB	is homologous to	clpB(Salmonella)
raiA	is homologous to	raiA(Salmonella)
lptB	is homologous to	lptB(Salmonella)
ptsN	is homologous to	ptsN(Salmonella)
sspB	is homologous to	sspB(Salmonella)
aaeR	is homologous to	aaeR(Salmonella)
tldD	is homologous to	tldD(Salmonella)
rng	is homologous to	rng(Salmonella)
yhdH	is homologous to	yhdH(Salmonella)
yhdJ	is homologous to	yhdJ(Salmonella)
rplQ	is homologous to	rplQ(Salmonella)
rplR	is homologous to	rplR(Salmonella)
rplN	is homologous to	rplN(Salmonella)
prkB	is homologous to	prkB(Salmonella)
gntR	is homologous to	gntR(Salmonella)
yhhN	is homologous to	yhhN(Salmonella)
rlmJ	is homologous to	rlmJ(Salmonella)
mtlA	is homologous to	mtlA(Salmonella)
mtlR	is homologous to	mtlR(Salmonella)
grxC	is homologous to	grxC(Salmonella)
xanP	is homologous to	xanP(Salmonella)
yicJ	is homologous to	yicJ(Salmonella)
rbsK	is homologous to	rbsK(Salmonella)
ilvN	is homologous to	ilvN(Salmonella)
yieE	is homologous to	yieE(Salmonella)
atpH	is homologous to	atpH(Salmonella)
atpB	is homologous to	atpB(Salmonella)
atpD	is homologous to	atpD(Salmonella)
atpA	is homologous to	atpA(Salmonella)
rbsC	is homologous to	rbsC(Salmonella)
tatC	is homologous to	tatC(Salmonella)
yihV	is homologous to	yihV(Salmonella)
fabY	is homologous to	fabY(Salmonella)
cpxA	is homologous to	cpxA(Salmonella)
yiiR	is homologous to	yiiR(Salmonella)
ygfX	is homologous to	ygfX(Salmonella)
oxyR	is homologous to	oxyR(Salmonella)
ubiA	is homologous to	ubiA(Salmonella)
aspA	is homologous to	aspA(Salmonella)
gdx	is homologous to	gdx(Salmonella)
rnr	is homologous to	rnr(Salmonella)
fklB	is homologous to	fklB(Salmonella)
paeA	is homologous to	paeA(Salmonella)
ytfP	is homologous to	ytfP(Salmonella)
hypT	is homologous to	hypT(Salmonella)
mdtM	is homologous to	mdtM(Salmonella)
osmY	is homologous to	osmY(Salmonella)
serB	is homologous to	serB(Salmonella)
creA	is homologous to	creA(Salmonella)
arcA	is homologous to	arcA(Salmonella)
galR	is homologous to	galR(Salmonella)
leuO	is homologous to	leuO(Salmonella)
wzzE	is homologous to	wzzE(Salmonella)
msbA	is homologous to	msbA(Salmonella)
btuD	is homologous to	btuD(Salmonella)
ftsH	is homologous to	ftsH(Salmonella)
cbpA	is homologous to	cbpA(Salmonella)
yjgM	is homologous to	yjgM(Salmonella)
argI	is homologous to	argI(Salmonella)
ydfG	is homologous to	ydfG(Salmonella)
csrA	is homologous to	csrA(Salmonella)
manZ	is homologous to	manZ(Salmonella)
pspA	is homologous to	pspA(Salmonella)
pspC	is homologous to	pspC(Salmonella)
mnaT	is homologous to	mnaT(Salmonella)
sad	is homologous to	sad(Salmonella)
comR	is homologous to	comR(Salmonella)
holB	is homologous to	holB(Salmonella)
chbC	is homologous to	chbC(Salmonella)
purK	is homologous to	purK(Salmonella)
kdpD	is homologous to	kdpD(Salmonella)
yqhA	is homologous to	yqhA(Salmonella)
obgE	is homologous to	obgE(Salmonella)
srlA	is homologous to	srlA(Salmonella)
nuoF	is homologous to	nuoF(Salmonella)
amiA	is homologous to	amiA(Salmonella)
hemF	is homologous to	hemF(Salmonella)
bfr	is homologous to	bfr(Salmonella)
setB	is homologous to	setB(Salmonella)
wzc	is homologous to	wzc(Salmonella)
polA	is homologous to	polA(Salmonella)
rplE	is homologous to	rplE(Salmonella)
fetB	is homologous to	fetB(Salmonella)
fcl	is homologous to	fcl(Salmonella)
cysH	is homologous to	cysH(Salmonella)
katG	is homologous to	katG(Salmonella)
proW	is homologous to	proW(Salmonella)
fruB	is homologous to	fruB(Salmonella)
der	is homologous to	der(Salmonella)
phr	is homologous to	phr(Salmonella)
manA	is homologous to	manA(Salmonella)
putA	is homologous to	putA(Salmonella)
putP	is homologous to	putP(Salmonella)
nei	is homologous to	nei(Salmonella)
pabB	is homologous to	pabB(Salmonella)
bioB	is homologous to	bioB(Salmonella)
bioA	is homologous to	bioA(Salmonella)
radA	is homologous to	radA(Salmonella)
argS	is homologous to	argS(Salmonella)
mrdA	is homologous to	mrdA(Salmonella)
rhtA	is homologous to	rhtA(Salmonella)
ampD	is homologous to	ampD(Salmonella)
napH	is homologous to	napH(Salmonella)
amn	is homologous to	amn(Salmonella)
iap	is homologous to	iap(Salmonella)
rlmN	is homologous to	rlmN(Salmonella)
pheA	is homologous to	pheA(Salmonella)
agp	is homologous to	agp(Salmonella)
kduD	is homologous to	kduD(Salmonella)
dsbB	is homologous to	dsbB(Salmonella)
hpt	is homologous to	hpt(Salmonella)
yicL	is homologous to	yicL(Salmonella)
yjjV	is homologous to	yjjV(Salmonella)
btsT	is homologous to	btsT(Salmonella)
lldD	is homologous to	lldD(Salmonella)
dam	is homologous to	dam(Salmonella)
phoQ	is homologous to	phoQ(Salmonella)
rplD	is homologous to	rplD(Salmonella)
uraA	is homologous to	uraA(Salmonella)
wcaF	is homologous to	wcaF(Salmonella)
gmd	is homologous to	gmd(Salmonella)
ampE	is homologous to	ampE(Salmonella)
rseB	is homologous to	rseB(Salmonella)
katE	is homologous to	katE(Salmonella)
waaG	is homologous to	waaG(Salmonella)
wcaA	is homologous to	wcaA(Salmonella)
bipA	is homologous to	bipA(Salmonella)
dgcC	is homologous to	dgcC(Salmonella)
fic	is homologous to	fic(Salmonella)
metF	is homologous to	metF(Salmonella)
coaA	is homologous to	coaA(Salmonella)
aceK	is homologous to	aceK(Salmonella)
aceA	is homologous to	aceA(Salmonella)
lplA	is homologous to	lplA(Salmonella)
fadB	is homologous to	fadB(Salmonella)
wecE	is homologous to	wecE(Salmonella)
rep	is homologous to	rep(Salmonella)
dctA	is homologous to	dctA(Salmonella)
envZ	is homologous to	envZ(Salmonella)
pyrE	is homologous to	pyrE(Salmonella)
rpsN	is homologous to	rpsN(Salmonella)
rpsF	is homologous to	rpsF(Salmonella)
yoaE	is homologous to	yoaE(Salmonella)
rnb	is homologous to	rnb(Salmonella)
fdnG	is homologous to	fdnG(Salmonella)
chbG	is homologous to	chbG(Salmonella)
nadE	is homologous to	nadE(Salmonella)
uup	is homologous to	uup(Salmonella)
ansA	is homologous to	ansA(Salmonella)
purB	is homologous to	purB(Salmonella)
lpxK	is homologous to	lpxK(Salmonella)
clpA	is homologous to	clpA(Salmonella)
ybiW	is homologous to	ybiW(Salmonella)
fepB	is homologous to	fepB(Salmonella)
modA	is homologous to	modA(Salmonella)
ybdK	is homologous to	ybdK(Salmonella)
cydA	is homologous to	cydA(Salmonella)
yfdH	is homologous to	yfdH(Salmonella)
ybcF	is homologous to	ybcF(Salmonella)
allR	is homologous to	allR(Salmonella)
acrB	is homologous to	acrB(Salmonella)
cyoE	is homologous to	cyoE(Salmonella)
ispA	is homologous to	ispA(Salmonella)
yajO	is homologous to	yajO(Salmonella)
ribD	is homologous to	ribD(Salmonella)
tgt	is homologous to	tgt(Salmonella)
pdxK	is homologous to	pdxK(Salmonella)
nuoJ	is homologous to	nuoJ(Salmonella)
yejB	is homologous to	yejB(Salmonella)
proA	is homologous to	proA(Salmonella)
cysA	is homologous to	cysA(Salmonella)
nlpD	is homologous to	nlpD(Salmonella)
prmC	is homologous to	prmC(Salmonella)
ilvI	is homologous to	ilvI(Salmonella)
ilvD	is homologous to	ilvD(Salmonella)
yddE	is homologous to	yddE(Salmonella)
qorA	is homologous to	qorA(Salmonella)
argD	is homologous to	argD(Salmonella)
flhA	is homologous to	flhA(Salmonella)
flhB	is homologous to	flhB(Salmonella)
recQ	is homologous to	recQ(Salmonella)
murI	is homologous to	murI(Salmonella)
lapC	is homologous to	lapC(Salmonella)
ldtA	is homologous to	ldtA(Salmonella)
slyA	is homologous to	slyA(Salmonella)
rimK	is homologous to	rimK(Salmonella)
prc	is homologous to	prc(Salmonella)
eptB	is homologous to	eptB(Salmonella)
glnB	is homologous to	glnB(Salmonella)
cspC	is homologous to	cspC(Salmonella)
cspA	is homologous to	cspA(Salmonella)
prfC	is homologous to	prfC(Salmonella)
nrdI	is homologous to	nrdI(Salmonella)
nrdH	is homologous to	nrdH(Salmonella)
bglX	is homologous to	bglX(Salmonella)
dnaK	is homologous to	dnaK(Salmonella)
moeA	is homologous to	moeA(Salmonella)
prpC	is homologous to	prpC(Salmonella)
prpB	is homologous to	prpB(Salmonella)
era	is homologous to	era(Salmonella)
apaG	is homologous to	apaG(Salmonella)
yaaJ	is homologous to	yaaJ(Salmonella)
yaaA	is homologous to	yaaA(Salmonella)
fhuD	is homologous to	fhuD(Salmonella)
yadH	is homologous to	yadH(Salmonella)
ftsZ	is homologous to	ftsZ(Salmonella)
murG	is homologous to	murG(Salmonella)
rsmH	is homologous to	rsmH(Salmonella)
ybaB	is homologous to	ybaB(Salmonella)
rpoA	is homologous to	rpoA(Salmonella)
rpsH	is homologous to	rpsH(Salmonella)
rpsE	is homologous to	rpsE(Salmonella)
rpsC	is homologous to	rpsC(Salmonella)
rpsL	is homologous to	rpsL(Salmonella)
rpmI	is homologous to	rpmI(Salmonella)
rpmG	is homologous to	rpmG(Salmonella)
rplT	is homologous to	rplT(Salmonella)
rplK	is homologous to	rplK(Salmonella)
ndk	is homologous to	ndk(Salmonella)
fis	is homologous to	fis(Salmonella)
acpP	is homologous to	acpP(Salmonella)
pgk	is homologous to	pgk(Salmonella)
rluD	is homologous to	rluD(Salmonella)
pyrG	is homologous to	pyrG(Salmonella)
fnr	is homologous to	fnr(Salmonella)
crp	is homologous to	crp(Salmonella)
marR	is homologous to	marR(Salmonella)
lrp	is homologous to	lrp(Salmonella)
corA	is homologous to	corA(Salmonella)
rpoC	is homologous to	rpoC(Salmonella)
metR	is homologous to	metR(Salmonella)
hdfR	is homologous to	hdfR(Salmonella)
cra	is homologous to	cra(Salmonella)
trpS	is homologous to	trpS(Salmonella)
rhlB	is homologous to	rhlB(Salmonella)
yjeM	is homologous to	yjeM(Salmonella)
upp	is homologous to	upp(Salmonella)
marC	is homologous to	marC(Salmonella)
ubiE	is homologous to	ubiE(Salmonella)
gltX	is homologous to	gltX(Salmonella)
trpB	is homologous to	trpB(Salmonella)
trkA	is homologous to	trkA(Salmonella)
sapB	is homologous to	sapB(Salmonella)
hisM	is homologous to	hisM(Salmonella)
parE	is homologous to	parE(Salmonella)
gyrB	is homologous to	gyrB(Salmonella)
fadA	is homologous to	fadA(Salmonella)
nanT	is homologous to	nanT(Salmonella)
smpB	is homologous to	smpB(Salmonella)
fliA	is homologous to	fliA(Salmonella)
glyA	is homologous to	glyA(Salmonella)
secE	is homologous to	secE(Salmonella)
fabG	is homologous to	fabG(Salmonella)
rnhB	is homologous to	rnhB(Salmonella)
rpsT	is homologous to	rpsT(Salmonella)
rpmB	is homologous to	rpmB(Salmonella)
rplA	is homologous to	rplA(Salmonella)
rplS	is homologous to	rplS(Salmonella)
bfd	is homologous to	bfd(Salmonella)
pyrB	is homologous to	pyrB(Salmonella)
skp	is homologous to	skp(Salmonella)
nuoC	is homologous to	nuoC(Salmonella)
nuoG	is homologous to	nuoG(Salmonella)
mutS	is homologous to	mutS(Salmonella)
rplL	is homologous to	rplL(Salmonella)
mscL	is homologous to	mscL(Salmonella)
rplJ	is homologous to	rplJ(Salmonella)
prmB	is homologous to	prmB(Salmonella)
brnQ	is homologous to	brnQ(Salmonella)
recO	is homologous to	recO(Salmonella)
lepA	is homologous to	lepA(Salmonella)
crr	is homologous to	crr(Salmonella)
lepB	is homologous to	lepB(Salmonella)
pth	is homologous to	pth(Salmonella)
psiE	is homologous to	psiE(Salmonella)
gpt	is homologous to	gpt(Salmonella)
prs	is homologous to	prs(Salmonella)
adk	is homologous to	adk(Salmonella)
ppx	is homologous to	ppx(Salmonella)
gpp	is homologous to	gpp(Salmonella)
bioP	is homologous to	bioP(Salmonella)
yigI	is homologous to	yigI(Salmonella)
plsC	is homologous to	plsC(Salmonella)
yceD	is homologous to	yceD(Salmonella)
ahpC	is homologous to	ahpC(Salmonella)
yajD	is homologous to	yajD(Salmonella)
ubiX	is homologous to	ubiX(Salmonella)
stpA	is homologous to	stpA(Salmonella)
hns	is homologous to	hns(Salmonella)
sulA	is homologous to	sulA(Salmonella)
ihfA	is homologous to	ihfA(Salmonella)
hupB	is homologous to	hupB(Salmonella)
hupA	is homologous to	hupA(Salmonella)
hisH	is homologous to	hisH(Salmonella)
hisF	is homologous to	hisF(Salmonella)
pldA	is homologous to	pldA(Salmonella)
hfq	is homologous to	hfq(Salmonella)
nirD	is homologous to	nirD(Salmonella)
hemC	is homologous to	hemC(Salmonella)
hemA	is homologous to	hemA(Salmonella)
dnaB	is homologous to	dnaB(Salmonella)
gloA	is homologous to	gloA(Salmonella)
glnA	is homologous to	glnA(Salmonella)
gpsA	is homologous to	gpsA(Salmonella)
gapA	is homologous to	gapA(Salmonella)
fliG	is homologous to	fliG(Salmonella)
flgG	is homologous to	flgG(Salmonella)
flgE	is homologous to	flgE(Salmonella)
flgD	is homologous to	flgD(Salmonella)
flgC	is homologous to	flgC(Salmonella)
exbB	is homologous to	exbB(Salmonella)
fusA	is homologous to	fusA(Salmonella)
dnaQ	is homologous to	dnaQ(Salmonella)
dnaJ	is homologous to	dnaJ(Salmonella)
udp	is homologous to	udp(Salmonella)
dapF	is homologous to	dapF(Salmonella)
ddlA	is homologous to	ddlA(Salmonella)
cysK	is homologous to	cysK(Salmonella)
hemN	is homologous to	hemN(Salmonella)
clpP	is homologous to	clpP(Salmonella)
groS	is homologous to	groS(Salmonella)
groL	is homologous to	groL(Salmonella)
ftsP	is homologous to	ftsP(Salmonella)
atpC	is homologous to	atpC(Salmonella)
aroF	is homologous to	aroF(Salmonella)
apaH	is homologous to	apaH(Salmonella)
cyaA	is homologous to	cyaA(Salmonella)
ilvE	is homologous to	ilvE(Salmonella)
alr	is homologous to	alr(Salmonella)
yciA	is homologous to	yciA(Salmonella)
bcsA	is homologous to	bcsA(Salmonella)
bcsB	is homologous to	bcsB(Salmonella)
glk	is homologous to	glk(Salmonella)
hisA	is homologous to	hisA(Salmonella)
hisD	is homologous to	hisD(Salmonella)
hisB	is homologous to	hisB(Salmonella)
rffG	is homologous to	rffG(Salmonella)
tdcB	is homologous to	tdcB(Salmonella)
yihY	is homologous to	yihY(Salmonella)
pyrF	is homologous to	pyrF(Salmonella)
aroA	is homologous to	aroA(Salmonella)
pyrC	is homologous to	pyrC(Salmonella)
oppA	is homologous to	oppA(Salmonella)
ushA	is homologous to	ushA(Salmonella)
pabA	is homologous to	pabA(Salmonella)
dadX	is homologous to	dadX(Salmonella)
araD	is homologous to	araD(Salmonella)
rpoB	is homologous to	rpoB(Salmonella)
cheW	is homologous to	cheW(Salmonella)
sodC	is homologous to	sodC(Salmonella)
purR	is homologous to	purR(Salmonella)
gshA	is homologous to	gshA(Salmonella)
pck	is homologous to	pck(Salmonella)
galS	is homologous to	galS(Salmonella)
malG	is homologous to	malG(Salmonella)
hpf	is homologous to	hpf(Salmonella)
uvrC	is homologous to	uvrC(Salmonella)
ilvC	is homologous to	ilvC(Salmonella)
nrdA	is homologous to	nrdA(Salmonella)
metH	is homologous to	metH(Salmonella)
gmk	is homologous to	gmk(Salmonella)
flgF	is homologous to	flgF(Salmonella)
gdhA	is homologous to	gdhA(Salmonella)
pgi	is homologous to	pgi(Salmonella)
ubiC	is homologous to	ubiC(Salmonella)
plsB	is homologous to	plsB(Salmonella)
dinF	is homologous to	dinF(Salmonella)
zur	is homologous to	zur(Salmonella)
ghxP	is homologous to	ghxP(Salmonella)
actP	is homologous to	actP(Salmonella)
nrfA	is homologous to	nrfA(Salmonella)
nrfB	is homologous to	nrfB(Salmonella)
nrfD	is homologous to	nrfD(Salmonella)
nrfG	is homologous to	nrfG(Salmonella)
gltP	is homologous to	gltP(Salmonella)
fdhF	is homologous to	fdhF(Salmonella)
dcuS	is homologous to	dcuS(Salmonella)
yjdC	is homologous to	yjdC(Salmonella)
dsbD	is homologous to	dsbD(Salmonella)
blc	is homologous to	blc(Salmonella)
psd	is homologous to	psd(Salmonella)
nnr	is homologous to	nnr(Salmonella)
tsaE	is homologous to	tsaE(Salmonella)
hflX	is homologous to	hflX(Salmonella)
nsrR	is homologous to	nsrR(Salmonella)
rlmB	is homologous to	rlmB(Salmonella)
yjiJ	is homologous to	yjiJ(Salmonella)
yjiN	is homologous to	yjiN(Salmonella)
mrr	is homologous to	mrr(Salmonella)
yjiA	is homologous to	yjiA(Salmonella)
tsr	is homologous to	tsr(Salmonella)
opgB	is homologous to	opgB(Salmonella)
dnaC	is homologous to	dnaC(Salmonella)
yjjP	is homologous to	yjjP(Salmonella)
yjfP	is homologous to	yjfP(Salmonella)
ulaD	is homologous to	ulaD(Salmonella)
ulaE	is homologous to	ulaE(Salmonella)
ulaF	is homologous to	ulaF(Salmonella)
rimI	is homologous to	rimI(Salmonella)
rpsR	is homologous to	rpsR(Salmonella)
rplI	is homologous to	rplI(Salmonella)
deoC	is homologous to	deoC(Salmonella)
deoD	is homologous to	deoD(Salmonella)
ytjC	is homologous to	ytjC(Salmonella)
fbp	is homologous to	fbp(Salmonella)
creB	is homologous to	creB(Salmonella)
creC	is homologous to	creC(Salmonella)
yjtD	is homologous to	yjtD(Salmonella)
arcB	is homologous to	arcB(Salmonella)
tabA	is homologous to	tabA(Salmonella)
valS	is homologous to	valS(Salmonella)
pepA	is homologous to	pepA(Salmonella)
idnK	is homologous to	idnK(Salmonella)
ahr	is homologous to	ahr(Salmonella)
yeeN	is homologous to	yeeN(Salmonella)
yedE	is homologous to	yedE(Salmonella)
nhaA	is homologous to	nhaA(Salmonella)
ileS	is homologous to	ileS(Salmonella)
rihC	is homologous to	rihC(Salmonella)
dapB	is homologous to	dapB(Salmonella)
caiC	is homologous to	caiC(Salmonella)
caiT	is homologous to	caiT(Salmonella)
yaaU	is homologous to	yaaU(Salmonella)
kefF	is homologous to	kefF(Salmonella)
kefC	is homologous to	kefC(Salmonella)
folA	is homologous to	folA(Salmonella)
lptD	is homologous to	lptD(Salmonella)
rluA	is homologous to	rluA(Salmonella)
polB	is homologous to	polB(Salmonella)
thiP	is homologous to	thiP(Salmonella)
sgrR	is homologous to	sgrR(Salmonella)
ddlB	is homologous to	ddlB(Salmonella)
secA	is homologous to	secA(Salmonella)
guaC	is homologous to	guaC(Salmonella)
aceF	is homologous to	aceF(Salmonella)
lpd	is homologous to	lpd(Salmonella)
acnB	is homologous to	acnB(Salmonella)
speD	is homologous to	speD(Salmonella)
speE	is homologous to	speE(Salmonella)
cueO	is homologous to	cueO(Salmonella)
can	is homologous to	can(Salmonella)
panC	is homologous to	panC(Salmonella)
panB	is homologous to	panB(Salmonella)
gluQ	is homologous to	gluQ(Salmonella)
sfsA	is homologous to	sfsA(Salmonella)
mrcB	is homologous to	mrcB(Salmonella)
fhuA	is homologous to	fhuA(Salmonella)
thrA	is homologous to	thrA(Salmonella)
dapD	is homologous to	dapD(Salmonella)
ispU	is homologous to	ispU(Salmonella)
lpxB	is homologous to	lpxB(Salmonella)
arfB	is homologous to	arfB(Salmonella)
trmO	is homologous to	trmO(Salmonella)
yafC	is homologous to	yafC(Salmonella)
yafS	is homologous to	yafS(Salmonella)
yafV	is homologous to	yafV(Salmonella)
fadE	is homologous to	fadE(Salmonella)
pepD	is homologous to	pepD(Salmonella)
yahN	is homologous to	yahN(Salmonella)
proC	is homologous to	proC(Salmonella)
ppnP	is homologous to	ppnP(Salmonella)
sbcD	is homologous to	sbcD(Salmonella)
phoR	is homologous to	phoR(Salmonella)
queA	is homologous to	queA(Salmonella)
secD	is homologous to	secD(Salmonella)
nusB	is homologous to	nusB(Salmonella)
dxs	is homologous to	dxs(Salmonella)
yajR	is homologous to	yajR(Salmonella)
cyoC	is homologous to	cyoC(Salmonella)
ampG	is homologous to	ampG(Salmonella)
clpX	is homologous to	clpX(Salmonella)
mdlA	is homologous to	mdlA(Salmonella)
mdlB	is homologous to	mdlB(Salmonella)
tesB	is homologous to	tesB(Salmonella)
maa	is homologous to	maa(Salmonella)
apt	is homologous to	apt(Salmonella)
aes	is homologous to	aes(Salmonella)
gsk	is homologous to	gsk(Salmonella)
leuS	is homologous to	leuS(Salmonella)
hscC	is homologous to	hscC(Salmonella)
rihA	is homologous to	rihA(Salmonella)
ubiF	is homologous to	ubiF(Salmonella)
asnB	is homologous to	asnB(Salmonella)
nagC	is homologous to	nagC(Salmonella)
nagB	is homologous to	nagB(Salmonella)
nagE	is homologous to	nagE(Salmonella)
glnS	is homologous to	glnS(Salmonella)
ybbP	is homologous to	ybbP(Salmonella)
pgm	is homologous to	pgm(Salmonella)
selU	is homologous to	selU(Salmonella)
allA	is homologous to	allA(Salmonella)
speF	is homologous to	speF(Salmonella)
ybbY	is homologous to	ybbY(Salmonella)
fdrA	is homologous to	fdrA(Salmonella)
lpxH	is homologous to	lpxH(Salmonella)
cysS	is homologous to	cysS(Salmonella)
sdhA	is homologous to	sdhA(Salmonella)
sucA	is homologous to	sucA(Salmonella)
sucD	is homologous to	sucD(Salmonella)
ybgC	is homologous to	ybgC(Salmonella)
tolA	is homologous to	tolA(Salmonella)
zitB	is homologous to	zitB(Salmonella)
ybdG	is homologous to	ybdG(Salmonella)
fepA	is homologous to	fepA(Salmonella)
modF	is homologous to	modF(Salmonella)
ybhA	is homologous to	ybhA(Salmonella)
pgl	is homologous to	pgl(Salmonella)
cstA	is homologous to	cstA(Salmonella)
bioF	is homologous to	bioF(Salmonella)
ybdL	is homologous to	ybdL(Salmonella)
ybdO	is homologous to	ybdO(Salmonella)
ybhL	is homologous to	ybhL(Salmonella)
rna	is homologous to	rna(Salmonella)
citT	is homologous to	citT(Salmonella)
clsB	is homologous to	clsB(Salmonella)
ybhR	is homologous to	ybhR(Salmonella)
citC	is homologous to	citC(Salmonella)
dpiB	is homologous to	dpiB(Salmonella)
dpiA	is homologous to	dpiA(Salmonella)
dcuC	is homologous to	dcuC(Salmonella)
lipB	is homologous to	lipB(Salmonella)
dinG	is homologous to	dinG(Salmonella)
ybiB	is homologous to	ybiB(Salmonella)
ybiI	is homologous to	ybiI(Salmonella)
rlmF	is homologous to	rlmF(Salmonella)
ybiO	is homologous to	ybiO(Salmonella)
opgE	is homologous to	opgE(Salmonella)
ybiT	is homologous to	ybiT(Salmonella)
gsiB	is homologous to	gsiB(Salmonella)
mdfA	is homologous to	mdfA(Salmonella)
rlmC	is homologous to	rlmC(Salmonella)
amiD	is homologous to	amiD(Salmonella)
hcp	is homologous to	hcp(Salmonella)
lysO	is homologous to	lysO(Salmonella)
ybjD	is homologous to	ybjD(Salmonella)
macA	is homologous to	macA(Salmonella)
macB	is homologous to	macB(Salmonella)
cydC	is homologous to	cydC(Salmonella)
cydD	is homologous to	cydD(Salmonella)
lolA	is homologous to	lolA(Salmonella)
dmsA	is homologous to	dmsA(Salmonella)
ycaM	is homologous to	ycaM(Salmonella)
ycaL	is homologous to	ycaL(Salmonella)
cmk	is homologous to	cmk(Salmonella)
kdsB	is homologous to	kdsB(Salmonella)
ldtD	is homologous to	ldtD(Salmonella)
roxA	is homologous to	roxA(Salmonella)
mnmA	is homologous to	mnmA(Salmonella)
yeaL	is homologous to	yeaL(Salmonella)
yeaG	is homologous to	yeaG(Salmonella)
yeaD	is homologous to	yeaD(Salmonella)
pncA	is homologous to	pncA(Salmonella)
selD	is homologous to	selD(Salmonella)
astC	is homologous to	astC(Salmonella)
astE	is homologous to	astE(Salmonella)
spy	is homologous to	spy(Salmonella)
yccS	is homologous to	yccS(Salmonella)
helD	is homologous to	helD(Salmonella)
tcyP	is homologous to	tcyP(Salmonella)
pfkB	is homologous to	pfkB(Salmonella)
btuC	is homologous to	btuC(Salmonella)
aroH	is homologous to	aroH(Salmonella)
ydiR	is homologous to	ydiR(Salmonella)
rutR	is homologous to	rutR(Salmonella)
ydiB	is homologous to	ydiB(Salmonella)
ydiM	is homologous to	ydiM(Salmonella)
ghrA	is homologous to	ghrA(Salmonella)
ydiJ	is homologous to	ydiJ(Salmonella)
opgH	is homologous to	opgH(Salmonella)
sufA	is homologous to	sufA(Salmonella)
rimJ	is homologous to	rimJ(Salmonella)
rne	is homologous to	rne(Salmonella)
rluC	is homologous to	rluC(Salmonella)
mdtK	is homologous to	mdtK(Salmonella)
ribC	is homologous to	ribC(Salmonella)
fhuE	is homologous to	fhuE(Salmonella)
lpoB	is homologous to	lpoB(Salmonella)
ldtC	is homologous to	ldtC(Salmonella)
mfd	is homologous to	mfd(Salmonella)
lolE	is homologous to	lolE(Salmonella)
punR	is homologous to	punR(Salmonella)
nemA	is homologous to	nemA(Salmonella)
ydhF	is homologous to	ydhF(Salmonella)
pdxY	is homologous to	pdxY(Salmonella)
dtpA	is homologous to	dtpA(Salmonella)
rsxD	is homologous to	rsxD(Salmonella)
add	is homologous to	add(Salmonella)
fumC	is homologous to	fumC(Salmonella)
rstA	is homologous to	rstA(Salmonella)
pntA	is homologous to	pntA(Salmonella)
ynfL	is homologous to	ynfL(Salmonella)
mlc	is homologous to	mlc(Salmonella)
speG	is homologous to	speG(Salmonella)
ynfA	is homologous to	ynfA(Salmonella)
ydfI	is homologous to	ydfI(Salmonella)
ydeE	is homologous to	ydeE(Salmonella)
yneJ	is homologous to	yneJ(Salmonella)
hypA	is homologous to	hypA(Salmonella)
maeA	is homologous to	maeA(Salmonella)
narZ	is homologous to	narZ(Salmonella)
narY	is homologous to	narY(Salmonella)
narW	is homologous to	narW(Salmonella)
narV	is homologous to	narV(Salmonella)
sutR	is homologous to	sutR(Salmonella)
tehA	is homologous to	tehA(Salmonella)
opgD	is homologous to	opgD(Salmonella)
ydcI	is homologous to	ydcI(Salmonella)
trg	is homologous to	trg(Salmonella)
cybB	is homologous to	cybB(Salmonella)
ydcF	is homologous to	ydcF(Salmonella)
hrpA	is homologous to	hrpA(Salmonella)
ydbK	is homologous to	ydbK(Salmonella)
mppA	is homologous to	mppA(Salmonella)
acnA	is homologous to	acnA(Salmonella)
ompW	is homologous to	ompW(Salmonella)
adhE	is homologous to	adhE(Salmonella)
narJ	is homologous to	narJ(Salmonella)
narH	is homologous to	narH(Salmonella)
narG	is homologous to	narG(Salmonella)
narK	is homologous to	narK(Salmonella)
ychO	is homologous to	ychO(Salmonella)
chaA	is homologous to	chaA(Salmonella)
treA	is homologous to	treA(Salmonella)
dadA	is homologous to	dadA(Salmonella)
nhaB	is homologous to	nhaB(Salmonella)
minD	is homologous to	minD(Salmonella)
sdaA	is homologous to	sdaA(Salmonella)
rlmA	is homologous to	rlmA(Salmonella)
kdgR	is homologous to	kdgR(Salmonella)
fliH	is homologous to	fliH(Salmonella)
flgJ	is homologous to	flgJ(Salmonella)
purT	is homologous to	purT(Salmonella)
zwf	is homologous to	zwf(Salmonella)
yebK	is homologous to	yebK(Salmonella)
pykA	is homologous to	pykA(Salmonella)
mepM	is homologous to	mepM(Salmonella)
znuC	is homologous to	znuC(Salmonella)
yecM	is homologous to	yecM(Salmonella)
ftnA	is homologous to	ftnA(Salmonella)
dcyD	is homologous to	dcyD(Salmonella)
yedI	is homologous to	yedI(Salmonella)
yegH	is homologous to	yegH(Salmonella)
asmA	is homologous to	asmA(Salmonella)
yegD	is homologous to	yegD(Salmonella)
mdtB	is homologous to	mdtB(Salmonella)
mdtD	is homologous to	mdtD(Salmonella)
baeR	is homologous to	baeR(Salmonella)
yegV	is homologous to	yegV(Salmonella)
metG	is homologous to	metG(Salmonella)
yehY	is homologous to	yehY(Salmonella)
dld	is homologous to	dld(Salmonella)
sanA	is homologous to	sanA(Salmonella)
preA	is homologous to	preA(Salmonella)
yeiG	is homologous to	yeiG(Salmonella)
cirA	is homologous to	cirA(Salmonella)
lysP	is homologous to	lysP(Salmonella)
yeiE	is homologous to	yeiE(Salmonella)
yeiH	is homologous to	yeiH(Salmonella)
nfo	is homologous to	nfo(Salmonella)
fruA	is homologous to	fruA(Salmonella)
yejE	is homologous to	yejE(Salmonella)
yejF	is homologous to	yejF(Salmonella)
bcr	is homologous to	bcr(Salmonella)
napC	is homologous to	napC(Salmonella)
napA	is homologous to	napA(Salmonella)
napF	is homologous to	napF(Salmonella)
yojI	is homologous to	yojI(Salmonella)
rcsD	is homologous to	rcsD(Salmonella)
glpQ	is homologous to	glpQ(Salmonella)
glpT	is homologous to	glpT(Salmonella)
glpA	is homologous to	glpA(Salmonella)
glpB	is homologous to	glpB(Salmonella)
yfaX	is homologous to	yfaX(Salmonella)
nudI	is homologous to	nudI(Salmonella)
arnB	is homologous to	arnB(Salmonella)
menF	is homologous to	menF(Salmonella)
nuoL	is homologous to	nuoL(Salmonella)
lrhA	is homologous to	lrhA(Salmonella)
yfbS	is homologous to	yfbS(Salmonella)
hxpA	is homologous to	hxpA(Salmonella)
purF	is homologous to	purF(Salmonella)
folC	is homologous to	folC(Salmonella)
fadJ	is homologous to	fadJ(Salmonella)
fadL	is homologous to	fadL(Salmonella)
nupC	is homologous to	nupC(Salmonella)
nfsB	is homologous to	nfsB(Salmonella)
leuA	is homologous to	leuA(Salmonella)
nadB	is homologous to	nadB(Salmonella)
srmB	is homologous to	srmB(Salmonella)
eamB	is homologous to	eamB(Salmonella)
xapA	is homologous to	xapA(Salmonella)
yfeR	is homologous to	yfeR(Salmonella)
yfeH	is homologous to	yfeH(Salmonella)
ligA	is homologous to	ligA(Salmonella)
bamD	is homologous to	bamD(Salmonella)
dgcN	is homologous to	dgcN(Salmonella)
talA	is homologous to	talA(Salmonella)
tktB	is homologous to	tktB(Salmonella)
recN	is homologous to	recN(Salmonella)
acrD	is homologous to	acrD(Salmonella)
dapE	is homologous to	dapE(Salmonella)
tmcA	is homologous to	tmcA(Salmonella)
gcvR	is homologous to	gcvR(Salmonella)
guaB	is homologous to	guaB(Salmonella)
sseA	is homologous to	sseA(Salmonella)
dtpC	is homologous to	dtpC(Salmonella)
glrK	is homologous to	glrK(Salmonella)
mltF	is homologous to	mltF(Salmonella)
yfhL	is homologous to	yfhL(Salmonella)
lhgD	is homologous to	lhgD(Salmonella)
gabD	is homologous to	gabD(Salmonella)
gabT	is homologous to	gabT(Salmonella)
kbp	is homologous to	kbp(Salmonella)
ygaP	is homologous to	ygaP(Salmonella)
emrB	is homologous to	emrB(Salmonella)
alaS	is homologous to	alaS(Salmonella)
srlE	is homologous to	srlE(Salmonella)
srlD	is homologous to	srlD(Salmonella)
hypF	is homologous to	hypF(Salmonella)
hycI	is homologous to	hycI(Salmonella)
hypB	is homologous to	hypB(Salmonella)
hypD	is homologous to	hypD(Salmonella)
pphB	is homologous to	pphB(Salmonella)
ygbM	is homologous to	ygbM(Salmonella)
truD	is homologous to	truD(Salmonella)
ispD	is homologous to	ispD(Salmonella)
mazG	is homologous to	mazG(Salmonella)
relA	is homologous to	relA(Salmonella)
truC	is homologous to	truC(Salmonella)
sdaB	is homologous to	sdaB(Salmonella)
ygdG	is homologous to	ygdG(Salmonella)
fucO	is homologous to	fucO(Salmonella)
fucA	is homologous to	fucA(Salmonella)
fucI	is homologous to	fucI(Salmonella)
fucK	is homologous to	fucK(Salmonella)
tcdA	is homologous to	tcdA(Salmonella)
mltA	is homologous to	mltA(Salmonella)
amiC	is homologous to	amiC(Salmonella)
recB	is homologous to	recB(Salmonella)
recC	is homologous to	recC(Salmonella)
ppdB	is homologous to	ppdB(Salmonella)
thyA	is homologous to	thyA(Salmonella)
aas	is homologous to	aas(Salmonella)
lysA	is homologous to	lysA(Salmonella)
qseC	is homologous to	qseC(Salmonella)
yqiK	is homologous to	yqiK(Salmonella)
ygiF	is homologous to	ygiF(Salmonella)
folB	is homologous to	folB(Salmonella)
aer	is homologous to	aer(Salmonella)
yqeF	is homologous to	yqeF(Salmonella)
fadH	is homologous to	fadH(Salmonella)
sstT	is homologous to	sstT(Salmonella)
yqjG	is homologous to	yqjG(Salmonella)
yhaJ	is homologous to	yhaJ(Salmonella)
cyuA	is homologous to	cyuA(Salmonella)
tdcA	is homologous to	tdcA(Salmonella)
yqfB	is homologous to	yqfB(Salmonella)
bglA	is homologous to	bglA(Salmonella)
garD	is homologous to	garD(Salmonella)
gcvP	is homologous to	gcvP(Salmonella)
gcvH	is homologous to	gcvH(Salmonella)
ubiI	is homologous to	ubiI(Salmonella)
argO	is homologous to	argO(Salmonella)
lpoA	is homologous to	lpoA(Salmonella)
tktA	is homologous to	tktA(Salmonella)
ubiT	is homologous to	ubiT(Salmonella)
yhbW	is homologous to	yhbW(Salmonella)
deaD	is homologous to	deaD(Salmonella)
pnp	is homologous to	pnp(Salmonella)
rsmE	is homologous to	rsmE(Salmonella)
argG	is homologous to	argG(Salmonella)
yggU	is homologous to	yggU(Salmonella)
hemW	is homologous to	hemW(Salmonella)
trmB	is homologous to	trmB(Salmonella)
nupG	is homologous to	nupG(Salmonella)
speC	is homologous to	speC(Salmonella)
gltB	is homologous to	gltB(Salmonella)
nanK	is homologous to	nanK(Salmonella)
nanA	is homologous to	nanA(Salmonella)
sspA	is homologous to	sspA(Salmonella)
zapE	is homologous to	zapE(Salmonella)
degQ	is homologous to	degQ(Salmonella)
hybB	is homologous to	hybB(Salmonella)
yghA	is homologous to	yghA(Salmonella)
yqhD	is homologous to	yqhD(Salmonella)
dkgA	is homologous to	dkgA(Salmonella)
panF	is homologous to	panF(Salmonella)
acrE	is homologous to	acrE(Salmonella)
acrF	is homologous to	acrF(Salmonella)
aroE	is homologous to	aroE(Salmonella)
tsaC	is homologous to	tsaC(Salmonella)
def	is homologous to	def(Salmonella)
fmt	is homologous to	fmt(Salmonella)
rsmB	is homologous to	rsmB(Salmonella)
rpsM	is homologous to	rpsM(Salmonella)
tusB	is homologous to	tusB(Salmonella)
tusD	is homologous to	tusD(Salmonella)
kefB	is homologous to	kefB(Salmonella)
yheS	is homologous to	yheS(Salmonella)
yhfK	is homologous to	yhfK(Salmonella)
gph	is homologous to	gph(Salmonella)
hofQ	is homologous to	hofQ(Salmonella)
mrcA	is homologous to	mrcA(Salmonella)
yrfG	is homologous to	yrfG(Salmonella)
hslO	is homologous to	hslO(Salmonella)
nfuA	is homologous to	nfuA(Salmonella)
rtcA	is homologous to	rtcA(Salmonella)
rtcB	is homologous to	rtcB(Salmonella)
glpD	is homologous to	glpD(Salmonella)
glgP	is homologous to	glgP(Salmonella)
glgB	is homologous to	glgB(Salmonella)
gntU	is homologous to	gntU(Salmonella)
yhhY	is homologous to	yhhY(Salmonella)
ugpC	is homologous to	ugpC(Salmonella)
ftsX	is homologous to	ftsX(Salmonella)
ftsY	is homologous to	ftsY(Salmonella)
zntA	is homologous to	zntA(Salmonella)
yhhT	is homologous to	yhhT(Salmonella)
acpT	is homologous to	acpT(Salmonella)
yhiI	is homologous to	yhiI(Salmonella)
dtpB	is homologous to	dtpB(Salmonella)
gor	is homologous to	gor(Salmonella)
treF	is homologous to	treF(Salmonella)
yhjG	is homologous to	yhjG(Salmonella)
kdgK	is homologous to	kdgK(Salmonella)
dppC	is homologous to	dppC(Salmonella)
bisC	is homologous to	bisC(Salmonella)
ghrB	is homologous to	ghrB(Salmonella)
torA	is homologous to	torA(Salmonella)
torR	is homologous to	torR(Salmonella)
yidA	is homologous to	yidA(Salmonella)
yidC	is homologous to	yidC(Salmonella)
yidZ	is homologous to	yidZ(Salmonella)
yieF	is homologous to	yieF(Salmonella)
adeP	is homologous to	adeP(Salmonella)
glyS	is homologous to	glyS(Salmonella)
glmS	is homologous to	glmS(Salmonella)
xylA	is homologous to	xylA(Salmonella)
atpG	is homologous to	atpG(Salmonella)
asnA	is homologous to	asnA(Salmonella)
yiaL	is homologous to	yiaL(Salmonella)
kup	is homologous to	kup(Salmonella)
rbsD	is homologous to	rbsD(Salmonella)
yiaO	is homologous to	yiaO(Salmonella)
rbsR	is homologous to	rbsR(Salmonella)
hsrA	is homologous to	hsrA(Salmonella)
selB	is homologous to	selB(Salmonella)
yibF	is homologous to	yibF(Salmonella)
yihG	is homologous to	yihG(Salmonella)
trmL	is homologous to	trmL(Salmonella)
yihS	is homologous to	yihS(Salmonella)
envC	is homologous to	envC(Salmonella)
waaH	is homologous to	waaH(Salmonella)
fdhE	is homologous to	fdhE(Salmonella)
waaA	is homologous to	waaA(Salmonella)
fdoG	is homologous to	fdoG(Salmonella)
dfp	is homologous to	dfp(Salmonella)
slmA	is homologous to	slmA(Salmonella)
ubiD	is homologous to	ubiD(Salmonella)
ligB	is homologous to	ligB(Salmonella)
spoT	is homologous to	spoT(Salmonella)
trmH	is homologous to	trmH(Salmonella)
recG	is homologous to	recG(Salmonella)
fieF	is homologous to	fieF(Salmonella)
lsrC	is homologous to	lsrC(Salmonella)
tpiA	is homologous to	tpiA(Salmonella)
ilvB	is homologous to	ilvB(Salmonella)
glpX	is homologous to	glpX(Salmonella)
glpF	is homologous to	glpF(Salmonella)
dsdC	is homologous to	dsdC(Salmonella)
dsdX	is homologous to	dsdX(Salmonella)
dsdA	is homologous to	dsdA(Salmonella)
priA	is homologous to	priA(Salmonella)
metB	is homologous to	metB(Salmonella)
metL	is homologous to	metL(Salmonella)
gldA	is homologous to	gldA(Salmonella)
frwC	is homologous to	frwC(Salmonella)
frwB	is homologous to	frwB(Salmonella)
pflD	is homologous to	pflD(Salmonella)
frwD	is homologous to	frwD(Salmonella)
ppc	is homologous to	ppc(Salmonella)
argE	is homologous to	argE(Salmonella)
argH	is homologous to	argH(Salmonella)
aceB	is homologous to	aceB(Salmonella)
lysC	is homologous to	lysC(Salmonella)
tdcD	is homologous to	tdcD(Salmonella)
metC	is homologous to	metC(Salmonella)
hyi	is homologous to	hyi(Salmonella)
edd	is homologous to	edd(Salmonella)
rsuA	is homologous to	rsuA(Salmonella)
eutC	is homologous to	eutC(Salmonella)
eutB	is homologous to	eutB(Salmonella)
malE	is homologous to	malE(Salmonella)
malK	is homologous to	malK(Salmonella)
rplX	is homologous to	rplX(Salmonella)
speB	is homologous to	speB(Salmonella)
yebC	is homologous to	yebC(Salmonella)
plsY	is homologous to	plsY(Salmonella)
ung	is homologous to	ung(Salmonella)
pheS	is homologous to	pheS(Salmonella)
zupT	is homologous to	zupT(Salmonella)
ybgI	is homologous to	ybgI(Salmonella)
rimP	is homologous to	rimP(Salmonella)
rpsJ	is homologous to	rpsJ(Salmonella)
yejK	is homologous to	yejK(Salmonella)
zapD	is homologous to	zapD(Salmonella)
prmA	is homologous to	prmA(Salmonella)
rraA	is homologous to	rraA(Salmonella)
clpS	is homologous to	clpS(Salmonella)
yggX	is homologous to	yggX(Salmonella)
aat	is homologous to	aat(Salmonella)
tmaR	is homologous to	tmaR(Salmonella)
opgG	is homologous to	opgG(Salmonella)
ybeD	is homologous to	ybeD(Salmonella)
uvrD	is homologous to	uvrD(Salmonella)
rnm	is homologous to	rnm(Salmonella)
mutM	is homologous to	mutM(Salmonella)
rpsD	is homologous to	rpsD(Salmonella)
rpsK	is homologous to	rpsK(Salmonella)
cobS	is homologous to	cobS(Salmonella)
rplF	is homologous to	rplF(Salmonella)
rpmA	is homologous to	rpmA(Salmonella)
mutY	is homologous to	mutY(Salmonella)
talB	is homologous to	talB(Salmonella)
tig	is homologous to	tig(Salmonella)
umpG	is homologous to	umpG(Salmonella)
sucC	is homologous to	sucC(Salmonella)
rplO	is homologous to	rplO(Salmonella)
ribE	is homologous to	ribE(Salmonella)
ribB	is homologous to	ribB(Salmonella)
ribA	is homologous to	ribA(Salmonella)
qseB	is homologous to	qseB(Salmonella)
metK	is homologous to	metK(Salmonella)
frr	is homologous to	frr(Salmonella)
rpiA	is homologous to	rpiA(Salmonella)
rnpA	is homologous to	rnpA(Salmonella)
rnt	is homologous to	rnt(Salmonella)
rpsI	is homologous to	rpsI(Salmonella)
rpsB	is homologous to	rpsB(Salmonella)
rpsS	is homologous to	rpsS(Salmonella)
rpsQ	is homologous to	rpsQ(Salmonella)
rpsO	is homologous to	rpsO(Salmonella)
fliJ	is homologous to	fliJ(Salmonella)
flgK	is homologous to	flgK(Salmonella)
eutL	is homologous to	eutL(Salmonella)
waaF	is homologous to	waaF(Salmonella)
alkB	is homologous to	alkB(Salmonella)
ygiW	is homologous to	ygiW(Salmonella)
proV	is homologous to	proV(Salmonella)
recA	is homologous to	recA(Salmonella)
yjjX	is homologous to	yjjX(Salmonella)
eutS	is homologous to	eutS(Salmonella)
eutQ	is homologous to	eutQ(Salmonella)
eutK	is homologous to	eutK(Salmonella)
nadK	is homologous to	nadK(Salmonella)
rfbB	is homologous to	rfbB(Salmonella)
rfbA	is homologous to	rfbA(Salmonella)
wzzB	is homologous to	wzzB(Salmonella)
degP	is homologous to	degP(Salmonella)
sseB	is homologous to	sseB(Salmonella)
fabI	is homologous to	fabI(Salmonella)
gmhB	is homologous to	gmhB(Salmonella)
pagP	is homologous to	pagP(Salmonella)
rflP	is homologous to	rflP(Salmonella)
bhsA	is homologous to	bhsA(Salmonella)
ackA	is homologous to	ackA(Salmonella)
thiC	is homologous to	thiC(Salmonella)
ilvA	is homologous to	ilvA(Salmonella)
adiC	is homologous to	adiC(Salmonella)
fliC	is homologous to	fliC(Salmonella)
fliS	is homologous to	fliS(Salmonella)
waaC	is homologous to	waaC(Salmonella)
fliI	is homologous to	fliI(Salmonella)
rfbC	is homologous to	rfbC(Salmonella)
ydeI	is homologous to	ydeI(Salmonella)
prpD	is homologous to	prpD(Salmonella)
trkH	is homologous to	trkH(Salmonella)
rfe	is homologous to	rfe(Salmonella)
cof	is homologous to	cof(Salmonella)
cobT	is homologous to	cobT(Salmonella)
eutM	is homologous to	eutM(Salmonella)
gnd	is homologous to	gnd(Salmonella)
ycgR	is homologous to	ycgR(Salmonella)
prpE	is homologous to	prpE(Salmonella)
ridA	is homologous to	ridA(Salmonella)
flgN	is homologous to	flgN(Salmonella)
glpK	is homologous to	glpK(Salmonella)
treR	is homologous to	treR(Salmonella)
mgtA	is homologous to	mgtA(Salmonella)
sapA	is homologous to	sapA(Salmonella)
basS	is homologous to	basS(Salmonella)
eptA	is homologous to	eptA(Salmonella)
trmD	is homologous to	trmD(Salmonella)
cpdB	is homologous to	cpdB(Salmonella)
cobC	is homologous to	cobC(Salmonella)
miaA	is homologous to	miaA(Salmonella)
narU	is homologous to	narU(Salmonella)
proY	is homologous to	proY(Salmonella)
rffM	is homologous to	rffM(Salmonella)
trpR	is homologous to	trpR(Salmonella)
ptsG	is homologous to	ptsG(Salmonella)
nusA	is homologous to	nusA(Salmonella)
kbl	is homologous to	kbl(Salmonella)
menE	is homologous to	menE(Salmonella)
birA	is homologous to	birA(Salmonella)
gyrA	is homologous to	gyrA(Salmonella)
btuB	is homologous to	btuB(Salmonella)
hemH	is homologous to	hemH(Salmonella)
panE	is homologous to	panE(Salmonella)
sfmH	is homologous to	sfmH(Salmonella)
fimD	is homologous to	fimD(Salmonella)
fimA	is homologous to	fimA(Salmonella)
murJ	is homologous to	murJ(Salmonella)
cysJ	is homologous to	cysJ(Salmonella)
dnaA	is homologous to	dnaA(Salmonella)
cysB	is homologous to	cysB(Salmonella)
deoA	is homologous to	deoA(Salmonella)
frdA	is homologous to	frdA(Salmonella)
yjdM	is homologous to	yjdM(Salmonella)
pepQ	is homologous to	pepQ(Salmonella)
yiaM	is homologous to	yiaM(Salmonella)
dppB	is homologous to	dppB(Salmonella)
nudE	is homologous to	nudE(Salmonella)
rplP	is homologous to	rplP(Salmonella)
iscR	is homologous to	iscR(Salmonella)
mlaE	is homologous to	mlaE(Salmonella)
mlaD	is homologous to	mlaD(Salmonella)
iscX	is homologous to	iscX(Salmonella)
ispB	is homologous to	ispB(Salmonella)
nlpI	is homologous to	nlpI(Salmonella)
bcp	is homologous to	bcp(Salmonella)
hybG	is homologous to	hybG(Salmonella)
fbaA	is homologous to	fbaA(Salmonella)
lysR	is homologous to	lysR(Salmonella)
ypjD	is homologous to	ypjD(Salmonella)
tsaB	is homologous to	tsaB(Salmonella)
lolC	is homologous to	lolC(Salmonella)
secF	is homologous to	secF(Salmonella)
yajC	is homologous to	yajC(Salmonella)
hemB	is homologous to	hemB(Salmonella)
mltD	is homologous to	mltD(Salmonella)
ftsL	is homologous to	ftsL(Salmonella)
cydB	is homologous to	cydB(Salmonella)
sdhD	is homologous to	sdhD(Salmonella)
rimO	is homologous to	rimO(Salmonella)
gsiC	is homologous to	gsiC(Salmonella)
entH	is homologous to	entH(Salmonella)
fepE	is homologous to	fepE(Salmonella)
aroG	is homologous to	aroG(Salmonella)
sdhB	is homologous to	sdhB(Salmonella)
pxpA	is homologous to	pxpA(Salmonella)
kdpA	is homologous to	kdpA(Salmonella)
kdpB	is homologous to	kdpB(Salmonella)
gcl	is homologous to	gcl(Salmonella)
cnoX	is homologous to	cnoX(Salmonella)
mak	is homologous to	mak(Salmonella)
dxr	is homologous to	dxr(Salmonella)
gcd	is homologous to	gcd(Salmonella)
mutT	is homologous to	mutT(Salmonella)
mraY	is homologous to	mraY(Salmonella)
mraZ	is homologous to	mraZ(Salmonella)
nadA	is homologous to	nadA(Salmonella)
pyrD	is homologous to	pyrD(Salmonella)
epmA	is homologous to	epmA(Salmonella)
carA	is homologous to	carA(Salmonella)
miaB	is homologous to	miaB(Salmonella)
mntH	is homologous to	mntH(Salmonella)
allS	is homologous to	allS(Salmonella)
pepB	is homologous to	pepB(Salmonella)
treC	is homologous to	treC(Salmonella)
creD	is homologous to	creD(Salmonella)
tamB	is homologous to	tamB(Salmonella)
msrA	is homologous to	msrA(Salmonella)
ytfB	is homologous to	ytfB(Salmonella)
yjfC	is homologous to	yjfC(Salmonella)
menA	is homologous to	menA(Salmonella)
emrD	is homologous to	emrD(Salmonella)
fpr	is homologous to	fpr(Salmonella)
cpxP	is homologous to	cpxP(Salmonella)
rhaD	is homologous to	rhaD(Salmonella)
lldP	is homologous to	lldP(Salmonella)
mobA	is homologous to	mobA(Salmonella)
sgbU	is homologous to	sgbU(Salmonella)
sgbH	is homologous to	sgbH(Salmonella)
yiaN	is homologous to	yiaN(Salmonella)
plaR	is homologous to	plaR(Salmonella)
mnmG	is homologous to	mnmG(Salmonella)
xylR	is homologous to	xylR(Salmonella)
mdtL	is homologous to	mdtL(Salmonella)
mnmE	is homologous to	mnmE(Salmonella)
dppA	is homologous to	dppA(Salmonella)
malP	is homologous to	malP(Salmonella)
gntT	is homologous to	gntT(Salmonella)
greB	is homologous to	greB(Salmonella)
yheT	is homologous to	yheT(Salmonella)
secY	is homologous to	secY(Salmonella)
aaeB	is homologous to	aaeB(Salmonella)
zapG	is homologous to	zapG(Salmonella)
lptA	is homologous to	lptA(Salmonella)
yrbG	is homologous to	yrbG(Salmonella)
rdgB	is homologous to	rdgB(Salmonella)
dacB	is homologous to	dacB(Salmonella)
rlmE	is homologous to	rlmE(Salmonella)
yqgF	is homologous to	yqgF(Salmonella)
yqgE	is homologous to	yqgE(Salmonella)
truB	is homologous to	truB(Salmonella)
rsmI	is homologous to	rsmI(Salmonella)
serA	is homologous to	serA(Salmonella)
ygfB	is homologous to	ygfB(Salmonella)
pepP	is homologous to	pepP(Salmonella)
ygfZ	is homologous to	ygfZ(Salmonella)
tdcE	is homologous to	tdcE(Salmonella)
tdcG	is homologous to	tdcG(Salmonella)
kduI	is homologous to	kduI(Salmonella)
nfeF	is homologous to	nfeF(Salmonella)
glnE	is homologous to	glnE(Salmonella)
cpdA	is homologous to	cpdA(Salmonella)
ppnN	is homologous to	ppnN(Salmonella)
cysN	is homologous to	cysN(Salmonella)
hycD	is homologous to	hycD(Salmonella)
pdxJ	is homologous to	pdxJ(Salmonella)
yfhH	is homologous to	yfhH(Salmonella)
cadC	is homologous to	cadC(Salmonella)
hscB	is homologous to	hscB(Salmonella)
hscA	is homologous to	hscA(Salmonella)
guaA	is homologous to	guaA(Salmonella)
dapA	is homologous to	dapA(Salmonella)
trxC	is homologous to	trxC(Salmonella)
xapB	is homologous to	xapB(Salmonella)
xapR	is homologous to	xapR(Salmonella)
yfcF	is homologous to	yfcF(Salmonella)
nuoM	is homologous to	nuoM(Salmonella)
yejA	is homologous to	yejA(Salmonella)
cdd	is homologous to	cdd(Salmonella)
mdtC	is homologous to	mdtC(Salmonella)
sbcB	is homologous to	sbcB(Salmonella)
cutC	is homologous to	cutC(Salmonella)
aspS	is homologous to	aspS(Salmonella)
znuB	is homologous to	znuB(Salmonella)
pphA	is homologous to	pphA(Salmonella)
msrC	is homologous to	msrC(Salmonella)
dauA	is homologous to	dauA(Salmonella)
smrA	is homologous to	smrA(Salmonella)
ldhA	is homologous to	ldhA(Salmonella)
ydcR	is homologous to	ydcR(Salmonella)
rstB	is homologous to	rstB(Salmonella)
pdxH	is homologous to	pdxH(Salmonella)
nagZ	is homologous to	nagZ(Salmonella)
punC	is homologous to	punC(Salmonella)
ycfH	is homologous to	ycfH(Salmonella)
fabF	is homologous to	fabF(Salmonella)
ldtE	is homologous to	ldtE(Salmonella)
ydiN	is homologous to	ydiN(Salmonella)
thrS	is homologous to	thrS(Salmonella)
yccA	is homologous to	yccA(Salmonella)
rlmL	is homologous to	rlmL(Salmonella)
dgcJ	is homologous to	dgcJ(Salmonella)
nagK	is homologous to	nagK(Salmonella)
ycaD	is homologous to	ycaD(Salmonella)
ilvH	is homologous to	ilvH(Salmonella)
mglB	is homologous to	mglB(Salmonella)
cysZ	is homologous to	cysZ(Salmonella)
cpsB	is homologous to	cpsB(Salmonella)
hmp	is homologous to	hmp(Salmonella)
galE	is homologous to	galE(Salmonella)
galK	is homologous to	galK(Salmonella)
trmA	is homologous to	trmA(Salmonella)
umuC	is homologous to	umuC(Salmonella)
pncB	is homologous to	pncB(Salmonella)
fabD	is homologous to	fabD(Salmonella)
ompL	is homologous to	ompL(Salmonella)
hisG	is homologous to	hisG(Salmonella)
pykF	is homologous to	pykF(Salmonella)
aroB	is homologous to	aroB(Salmonella)
bamA	is homologous to	bamA(Salmonella)
trpC	is homologous to	trpC(Salmonella)
trpD	is homologous to	trpD(Salmonella)
feoB	is homologous to	feoB(Salmonella)
purM	is homologous to	purM(Salmonella)
tyrB	is homologous to	tyrB(Salmonella)
udk	is homologous to	udk(Salmonella)
arnT	is homologous to	arnT(Salmonella)
trxA	is homologous to	trxA(Salmonella)
rplM	is homologous to	rplM(Salmonella)
nusG	is homologous to	nusG(Salmonella)
eutH	is homologous to	eutH(Salmonella)
eutG	is homologous to	eutG(Salmonella)
ftp	is homologous to	ftp(Salmonella)
hisS	is homologous to	hisS(Salmonella)
mglC	is homologous to	mglC(Salmonella)
livF	is homologous to	livF(Salmonella)
ilvY	is homologous to	ilvY(Salmonella)
rdgC	is homologous to	rdgC(Salmonella)
pyrH	is homologous to	pyrH(Salmonella)
tmk	is homologous to	tmk(Salmonella)
kdsA	is homologous to	kdsA(Salmonella)
yciB	is homologous to	yciB(Salmonella)
purC	is homologous to	purC(Salmonella)
purA	is homologous to	purA(Salmonella)
proB	is homologous to	proB(Salmonella)
ppa	is homologous to	ppa(Salmonella)
pfkA	is homologous to	pfkA(Salmonella)
panD	is homologous to	panD(Salmonella)
orn	is homologous to	orn(Salmonella)
rsxE	is homologous to	rsxE(Salmonella)
murA	is homologous to	murA(Salmonella)
msrB	is homologous to	msrB(Salmonella)
moaE	is homologous to	moaE(Salmonella)
moaA	is homologous to	moaA(Salmonella)
minE	is homologous to	minE(Salmonella)
mgsA	is homologous to	mgsA(Salmonella)
uhpT	is homologous to	uhpT(Salmonella)
uhpC	is homologous to	uhpC(Salmonella)
prlC	is homologous to	prlC(Salmonella)
dcp	is homologous to	dcp(Salmonella)
purH	is homologous to	purH(Salmonella)
parC	is homologous to	parC(Salmonella)
malF	is homologous to	malF(Salmonella)
lamB	is homologous to	lamB(Salmonella)
dnaN	is homologous to	dnaN(Salmonella)
fliM	is homologous to	fliM(Salmonella)
fliL	is homologous to	fliL(Salmonella)
cysM	is homologous to	cysM(Salmonella)
cysE	is homologous to	cysE(Salmonella)
lysS	is homologous to	lysS(Salmonella)
recF	is homologous to	recF(Salmonella)
nadR	is homologous to	nadR(Salmonella)
nhoA	is homologous to	nhoA(Salmonella)
proQ	is homologous to	proQ(Salmonella)
yjgA	is homologous to	yjgA(Salmonella)
pdxB	is homologous to	pdxB(Salmonella)
rplC	is homologous to	rplC(Salmonella)
rplB	is homologous to	rplB(Salmonella)
lolD	is homologous to	lolD(Salmonella)
rplV	is homologous to	rplV(Salmonella)
purN	is homologous to	purN(Salmonella)
wcaJ	is homologous to	wcaJ(Salmonella)
arnC	is homologous to	arnC(Salmonella)
dinB	is homologous to	dinB(Salmonella)
deoB	is homologous to	deoB(Salmonella)
dcd	is homologous to	dcd(Salmonella)
crcB	is homologous to	crcB(Salmonella)
clsA	is homologous to	clsA(Salmonella)
sdhC	is homologous to	sdhC(Salmonella)
aroK	is homologous to	aroK(Salmonella)
argB	is homologous to	argB(Salmonella)
ihfB	is homologous to	ihfB(Salmonella)
speA	is homologous to	speA(Salmonella)
greA	is homologous to	greA(Salmonella)
rsmG	is homologous to	rsmG(Salmonella)
gcvT	is homologous to	gcvT(Salmonella)
folE	is homologous to	folE(Salmonella)
nrdB	is homologous to	nrdB(Salmonella)
fixB	is homologous to	fixB(Salmonella)
eno	is homologous to	eno(Salmonella)
yihA	is homologous to	yihA(Salmonella)
efp	is homologous to	efp(Salmonella)
wzxE	is homologous to	wzxE(Salmonella)
rhtC	is homologous to	rhtC(Salmonella)
pldB	is homologous to	pldB(Salmonella)
tatD	is homologous to	tatD(Salmonella)
yigZ	is homologous to	yigZ(Salmonella)
hemG	is homologous to	hemG(Salmonella)
nrdD	is homologous to	nrdD(Salmonella)
nrdG	is homologous to	nrdG(Salmonella)
thiI	is homologous to	thiI(Salmonella)
serC	is homologous to	serC(Salmonella)
thiD	is homologous to	thiD(Salmonella)
amiB	is homologous to	amiB(Salmonella)
pepT	is homologous to	pepT(Salmonella)
cysQ	is homologous to	cysQ(Salmonella)
gltI	is homologous to	gltI(Salmonella)
infB	is homologous to	infB(Salmonella)
tonB	is homologous to	tonB(Salmonella)
nirC	is homologous to	nirC(Salmonella)
cysG	is homologous to	cysG(Salmonella)
thiF	is homologous to	thiF(Salmonella)
nudC	is homologous to	nudC(Salmonella)
yihT	is homologous to	yihT(Salmonella)
yihP	is homologous to	yihP(Salmonella)
yihO	is homologous to	yihO(Salmonella)
aroC	is homologous to	aroC(Salmonella)
pdxA	is homologous to	pdxA(Salmonella)
asnS	is homologous to	asnS(Salmonella)
folD	is homologous to	folD(Salmonella)
ispG	is homologous to	ispG(Salmonella)
aspC	is homologous to	aspC(Salmonella)
yceF	is homologous to	yceF(Salmonella)
gshB	is homologous to	gshB(Salmonella)
suhB	is homologous to	suhB(Salmonella)
dtd	is homologous to	dtd(Salmonella)
solA	is homologous to	solA(Salmonella)
argP	is homologous to	argP(Salmonella)
nfi	is homologous to	nfi(Salmonella)
atpE	is homologous to	atpE(Salmonella)
cyaY	is homologous to	cyaY(Salmonella)
fliR	is homologous to	fliR(Salmonella)
